geoid,name,B19058001,"B19058001, Error",B19058002,"B19058002, Error",B19058003,"B19058003, Error"
04000US39,Ohio,4633145,10307,689048,5091,3944097,12368
86000US16159,16159,1944,149,282,94,1662,156
86000US43001,43001,1052,125,46,29,1006,130
86000US43002,43002,1877,390,0,11,1877,390
86000US43003,43003,1023,135,165,54,858,132
86000US43004,43004,9558,490,671,222,8887,477
86000US43005,43005,93,53,0,11,93,53
86000US43006,43006,240,81,16,16,224,81
86000US43008,43008,1070,104,302,98,768,129
86000US43009,43009,782,107,14,12,768,108
86000US43010,43010,102,40,17,14,85,36
86000US43011,43011,2891,195,221,78,2670,205
86000US43013,43013,397,80,10,8,387,78
86000US43014,43014,1305,118,148,52,1157,127
86000US43015,43015,19648,361,1513,228,18135,420
86000US43016,43016,14587,525,446,166,14141,549
86000US43017,43017,14678,373,709,210,13969,434
86000US43019,43019,3423,240,348,99,3075,226
86000US43021,43021,3848,231,68,51,3780,232
86000US43022,43022,1135,158,25,26,1110,158
86000US43023,43023,3899,226,194,102,3705,208
86000US43025,43025,2149,189,202,66,1947,192
86000US43026,43026,22972,510,1569,356,21403,560
86000US43028,43028,3032,243,239,114,2793,292
86000US43029,43029,198,51,6,10,192,51
86000US43030,43030,52,83,0,11,52,83
86000US43031,43031,5035,290,291,110,4744,301
86000US43032,43032,21,22,0,11,21,22
86000US43033,43033,128,34,31,16,97,32
86000US43035,43035,8595,230,362,107,8233,259
86000US43036,43036,120,29,23,13,97,26
86000US43037,43037,119,38,28,21,91,30
86000US43040,43040,11671,294,1002,232,10669,354
86000US43044,43044,1901,129,167,43,1734,144
86000US43045,43045,683,105,15,11,668,104
86000US43046,43046,1413,105,189,74,1224,113
86000US43050,43050,11333,368,2076,268,9257,388
86000US43054,43054,9445,352,138,98,9307,341
86000US43055,43055,24590,540,4952,380,19638,604
86000US43056,43056,7298,342,717,201,6581,369
86000US43060,43060,954,83,87,32,867,88
86000US43061,43061,1531,132,91,45,1440,130
86000US43062,43062,10403,300,821,206,9582,395
86000US43064,43064,4740,200,352,143,4388,255
86000US43065,43065,14871,363,338,102,14533,362
86000US43066,43066,545,100,0,11,545,100
86000US43067,43067,586,99,27,21,559,99
86000US43068,43068,21626,513,2486,289,19140,541
86000US43070,43070,53,32,0,11,53,32
86000US43071,43071,720,122,85,50,635,118
86000US43072,43072,2239,131,281,115,1958,159
86000US43074,43074,4352,222,142,69,4210,227
86000US43076,43076,3483,277,543,164,2940,278
86000US43077,43077,122,52,2,3,120,52
86000US43078,43078,8476,235,1278,206,7198,270
86000US43080,43080,1881,207,311,94,1570,218
86000US43081,43081,23968,585,1284,256,22684,642
86000US43082,43082,11667,326,207,99,11460,312
86000US43084,43084,278,56,39,28,239,57
86000US43085,43085,10298,307,377,118,9921,327
86000US43101,43101,113,32,44,22,69,26
86000US43102,43102,1631,167,215,92,1416,157
86000US43103,43103,3933,271,268,118,3665,295
86000US43105,43105,2906,161,261,86,2645,175
86000US43106,43106,671,100,134,55,537,98
86000US43107,43107,1242,103,178,77,1064,115
86000US43109,43109,41,15,10,9,31,15
86000US43110,43110,13904,683,1619,597,12285,712
86000US43111,43111,140,51,18,19,122,52
86000US43112,43112,1616,142,103,50,1513,151
86000US43113,43113,9205,333,1709,267,7496,383
86000US43115,43115,546,104,168,63,378,96
86000US43116,43116,506,71,19,13,487,71
86000US43117,43117,60,51,33,40,27,28
86000US43119,43119,10133,375,1321,302,8812,433
86000US43123,43123,24014,509,1995,323,22019,582
86000US43125,43125,5598,486,443,132,5155,527
86000US43126,43126,188,54,31,22,157,47
86000US43127,43127,95,84,57,60,38,56
86000US43128,43128,884,89,179,46,705,97
86000US43130,43130,23404,447,4888,468,18516,601
86000US43135,43135,1608,167,313,101,1295,157
86000US43136,43136,266,50,6,7,260,50
86000US43137,43137,807,167,141,88,666,154
86000US43138,43138,7400,327,1673,254,5727,331
86000US43140,43140,7667,226,1179,217,6488,296
86000US43142,43142,60,22,8,7,52,22
86000US43143,43143,2081,129,350,73,1731,127
86000US43144,43144,169,42,43,20,126,36
86000US43145,43145,755,95,128,48,627,90
86000US43146,43146,3091,224,305,105,2786,245
86000US43147,43147,13808,371,760,205,13048,460
86000US43148,43148,832,119,207,68,625,115
86000US43149,43149,1004,112,166,76,838,112
86000US43150,43150,790,136,44,29,746,136
86000US43151,43151,90,25,9,8,81,24
86000US43152,43152,328,87,97,54,231,77
86000US43153,43153,345,70,32,17,313,67
86000US43154,43154,1130,165,171,96,959,149
86000US43155,43155,975,125,132,77,843,131
86000US43156,43156,59,19,11,8,48,18
86000US43157,43157,203,46,66,27,137,39
86000US43158,43158,102,28,25,26,77,26
86000US43160,43160,9237,241,1746,251,7491,291
86000US43162,43162,2539,146,386,115,2153,143
86000US43164,43164,732,105,122,43,610,108
86000US43201,43201,11877,409,1386,231,10491,409
86000US43202,43202,9576,302,598,157,8978,320
86000US43203,43203,3601,229,1348,193,2253,182
86000US43204,43204,16545,447,3959,371,12586,474
86000US43205,43205,5345,248,1776,216,3569,260
86000US43206,43206,9967,347,1982,242,7985,334
86000US43207,43207,17589,389,4443,350,13146,499
86000US43209,43209,11681,301,1384,181,10297,294
86000US43210,43210,338,75,21,20,317,73
86000US43211,43211,8357,341,3612,339,4745,316
86000US43212,43212,10512,337,284,89,10228,328
86000US43213,43213,14334,458,3424,359,10910,503
86000US43214,43214,12424,296,655,148,11769,295
86000US43215,43215,8890,370,1257,243,7633,369
86000US43217,43217,760,72,197,66,563,76
86000US43219,43219,11319,351,3225,316,8094,386
86000US43220,43220,11812,321,514,149,11298,359
86000US43221,43221,13354,361,396,153,12958,386
86000US43222,43222,1235,243,506,156,729,202
86000US43223,43223,8274,395,2887,335,5387,407
86000US43224,43224,17068,417,5389,477,11679,498
86000US43227,43227,9525,248,2893,272,6632,327
86000US43228,43228,21211,579,4879,563,16332,658
86000US43229,43229,20689,434,4080,471,16609,528
86000US43230,43230,22986,477,1063,233,21923,502
86000US43231,43231,7885,290,1377,247,6508,342
86000US43232,43232,18032,590,4760,521,13272,677
86000US43235,43235,17621,437,1009,282,16612,501
86000US43240,43240,1896,141,103,70,1793,160
86000US43302,43302,20320,479,4573,363,15747,461
86000US43310,43310,1191,146,89,47,1102,141
86000US43311,43311,7576,354,1356,234,6220,395
86000US43314,43314,1096,151,56,38,1040,150
86000US43315,43315,2514,212,350,92,2164,218
86000US43316,43316,2430,126,183,81,2247,131
86000US43317,43317,36,18,5,6,31,17
86000US43318,43318,1537,172,154,81,1383,178
86000US43319,43319,371,117,0,11,371,117
86000US43320,43320,691,122,88,53,603,109
86000US43321,43321,99,30,10,8,89,30
86000US43322,43322,132,39,29,19,103,33
86000US43323,43323,306,68,9,7,297,67
86000US43324,43324,1274,166,43,26,1231,165
86000US43326,43326,5233,240,829,199,4404,263
86000US43330,43330,63,23,13,10,50,20
86000US43331,43331,2190,177,325,82,1865,215
86000US43332,43332,730,120,77,35,653,121
86000US43333,43333,249,90,19,18,230,91
86000US43334,43334,2262,193,301,119,1961,225
86000US43336,43336,0,11,0,11,0,11
86000US43337,43337,414,108,34,25,380,108
86000US43338,43338,3838,240,647,194,3191,267
86000US43340,43340,627,94,52,27,575,96
86000US43341,43341,453,98,23,18,430,99
86000US43342,43342,1147,154,52,35,1095,152
86000US43343,43343,523,99,56,30,467,93
86000US43344,43344,2180,163,216,62,1964,174
86000US43345,43345,292,46,33,16,259,45
86000US43347,43347,572,74,46,21,526,71
86000US43348,43348,848,196,239,81,609,160
86000US43351,43351,4248,153,470,121,3778,170
86000US43356,43356,512,104,52,46,460,93
86000US43357,43357,1587,160,103,45,1484,159
86000US43358,43358,1030,164,66,29,964,160
86000US43359,43359,325,52,12,14,313,51
86000US43360,43360,691,127,38,18,653,124
86000US43402,43402,13466,416,1211,232,12255,460
86000US43403,43403,9,16,0,16,9,16
86000US43406,43406,735,79,145,59,590,76
86000US43407,43407,274,85,8,11,266,88
86000US43408,43408,121,34,14,12,107,32
86000US43410,43410,4051,212,342,121,3709,223
86000US43412,43412,1815,132,181,99,1634,141
86000US43413,43413,555,70,43,28,512,65
86000US43416,43416,1204,142,168,66,1036,124
86000US43420,43420,12471,334,1937,238,10534,347
86000US43430,43430,1718,126,157,71,1561,142
86000US43431,43431,1725,109,189,71,1536,137
86000US43432,43432,540,100,16,23,524,102
86000US43433,43433,18,19,0,11,18,19
86000US43434,43434,21,10,5,5,16,9
86000US43435,43435,500,91,50,30,450,99
86000US43437,43437,190,42,20,14,170,39
86000US43438,43438,104,27,4,5,100,27
86000US43439,43439,17,20,0,11,17,20
86000US43440,43440,2506,109,183,80,2323,130
86000US43442,43442,457,81,44,26,413,78
86000US43443,43443,756,93,33,32,723,92
86000US43445,43445,430,83,24,25,406,82
86000US43446,43446,45,12,0,11,45,12
86000US43447,43447,1298,175,118,65,1180,180
86000US43449,43449,3285,229,353,126,2932,244
86000US43450,43450,1355,98,48,34,1307,102
86000US43451,43451,422,84,34,24,388,80
86000US43452,43452,6201,207,701,144,5500,226
86000US43456,43456,214,37,8,11,206,36
86000US43457,43457,539,77,78,28,461,71
86000US43458,43458,157,34,25,16,132,32
86000US43460,43460,2634,137,123,74,2511,177
86000US43462,43462,493,65,60,43,433,59
86000US43463,43463,17,15,9,14,8,14
86000US43464,43464,415,109,14,16,401,114
86000US43465,43465,2476,190,178,76,2298,190
86000US43466,43466,794,70,54,28,740,65
86000US43467,43467,32,18,3,4,29,17
86000US43468,43468,106,42,0,11,106,42
86000US43469,43469,1162,127,134,55,1028,123
86000US43501,43501,324,77,43,35,281,76
86000US43502,43502,2520,131,265,89,2255,153
86000US43504,43504,478,41,18,12,460,41
86000US43505,43505,37,15,4,4,33,14
86000US43506,43506,6187,214,886,193,5301,282
86000US43511,43511,399,75,18,15,381,75
86000US43512,43512,11304,270,1456,217,9848,338
86000US43515,43515,3304,194,414,113,2890,202
86000US43516,43516,1082,117,106,44,976,111
86000US43517,43517,1614,123,154,47,1460,123
86000US43518,43518,1012,96,111,54,901,105
86000US43519,43519,96,37,26,40,70,31
86000US43521,43521,1176,113,223,55,953,116
86000US43522,43522,1193,103,65,35,1128,97
86000US43523,43523,0,11,0,11,0,11
86000US43524,43524,502,78,48,29,454,76
86000US43525,43525,438,62,5,7,433,64
86000US43526,43526,2305,156,209,80,2096,159
86000US43527,43527,763,81,78,35,685,77
86000US43528,43528,6323,328,740,181,5583,360
86000US43529,43529,111,34,16,13,95,31
86000US43531,43531,135,74,61,52,74,65
86000US43532,43532,1552,112,90,45,1462,120
86000US43533,43533,624,90,40,25,584,89
86000US43534,43534,707,98,53,28,654,95
86000US43535,43535,309,56,12,11,297,55
86000US43536,43536,110,60,9,15,101,61
86000US43537,43537,11206,396,771,148,10435,425
86000US43540,43540,535,85,14,14,521,86
86000US43541,43541,64,23,8,8,56,20
86000US43542,43542,1340,224,26,40,1314,222
86000US43543,43543,3301,185,459,109,2842,202
86000US43545,43545,5904,211,587,116,5317,223
86000US43547,43547,95,30,0,11,95,30
86000US43548,43548,257,46,14,12,243,47
86000US43549,43549,537,90,18,17,519,91
86000US43551,43551,15565,360,822,190,14743,412
86000US43553,43553,57,29,8,14,49,27
86000US43554,43554,1020,107,125,43,895,106
86000US43555,43555,82,41,27,36,55,27
86000US43556,43556,664,87,125,46,539,84
86000US43557,43557,926,98,58,29,868,92
86000US43558,43558,5199,225,513,134,4686,233
86000US43560,43560,11891,358,797,196,11094,387
86000US43565,43565,175,37,8,8,167,37
86000US43566,43566,2902,225,86,50,2816,228
86000US43567,43567,5014,209,512,159,4502,224
86000US43569,43569,1104,106,140,46,964,99
86000US43570,43570,1314,99,177,47,1137,108
86000US43571,43571,2704,172,157,81,2547,198
86000US43604,43604,4371,205,2488,203,1883,175
86000US43605,43605,10219,291,4394,333,5825,341
86000US43606,43606,10182,324,1796,236,8386,331
86000US43607,43607,9248,471,2868,259,6380,417
86000US43608,43608,4995,252,2291,209,2704,241
86000US43609,43609,8891,323,3384,377,5507,391
86000US43610,43610,1843,144,751,147,1092,123
86000US43611,43611,7942,351,1966,220,5976,335
86000US43612,43612,11743,356,2706,354,9037,375
86000US43613,43613,13790,327,2247,274,11543,406
86000US43614,43614,14268,382,1990,327,12278,489
86000US43615,43615,18040,526,3317,386,14723,575
86000US43616,43616,8549,259,942,168,7607,306
86000US43617,43617,2710,218,109,63,2601,219
86000US43619,43619,3050,176,320,147,2730,188
86000US43620,43620,2565,166,1095,146,1470,149
86000US43623,43623,9201,221,1012,181,8189,293
86000US43701,43701,23159,499,5493,461,17666,576
86000US43711,43711,26,34,0,11,26,34
86000US43713,43713,2734,195,384,143,2350,230
86000US43716,43716,794,118,115,82,679,98
86000US43717,43717,102,44,8,7,94,42
86000US43718,43718,1272,127,109,61,1163,144
86000US43719,43719,1065,140,169,83,896,133
86000US43720,43720,523,106,106,65,417,87
86000US43721,43721,0,11,0,11,0,11
86000US43722,43722,100,38,11,17,89,35
86000US43723,43723,2017,151,438,106,1579,172
86000US43724,43724,2865,211,354,120,2511,213
86000US43725,43725,8432,317,1990,241,6442,336
86000US43727,43727,388,84,60,44,328,79
86000US43728,43728,510,109,148,71,362,78
86000US43730,43730,869,114,160,69,709,96
86000US43731,43731,2095,157,517,117,1578,158
86000US43732,43732,666,106,81,63,585,102
86000US43733,43733,0,11,0,11,0,11
86000US43734,43734,678,98,77,61,601,105
86000US43735,43735,178,63,34,37,144,63
86000US43736,43736,31,12,14,9,17,12
86000US43738,43738,38,21,7,8,31,17
86000US43739,43739,835,147,10,11,825,146
86000US43740,43740,117,30,20,20,97,27
86000US43746,43746,504,116,48,49,456,123
86000US43747,43747,347,95,98,69,249,82
86000US43748,43748,931,137,204,98,727,181
86000US43749,43749,1016,155,164,96,852,152
86000US43750,43750,83,61,0,11,83,61
86000US43754,43754,617,100,99,55,518,99
86000US43755,43755,727,120,129,73,598,97
86000US43756,43756,2248,161,459,115,1789,147
86000US43758,43758,1204,138,247,77,957,135
86000US43759,43759,25,14,8,10,17,10
86000US43760,43760,801,146,95,60,706,153
86000US43761,43761,22,34,0,11,22,34
86000US43762,43762,1754,175,175,64,1579,169
86000US43764,43764,3204,239,880,187,2324,252
86000US43766,43766,602,105,207,80,395,86
86000US43767,43767,430,79,56,31,374,72
86000US43768,43768,131,32,17,17,114,26
86000US43771,43771,614,81,113,41,501,82
86000US43772,43772,652,107,39,22,613,106
86000US43773,43773,1350,180,139,79,1211,163
86000US43777,43777,1790,131,491,100,1299,132
86000US43778,43778,413,77,59,33,354,77
86000US43779,43779,409,105,86,63,323,88
86000US43780,43780,790,149,52,25,738,152
86000US43782,43782,262,68,90,31,172,64
86000US43783,43783,1863,212,354,123,1509,188
86000US43786,43786,18,9,2,4,16,9
86000US43787,43787,1163,123,208,62,955,119
86000US43788,43788,269,69,29,20,240,71
86000US43793,43793,2304,199,416,107,1888,201
86000US43802,43802,383,56,69,46,314,53
86000US43804,43804,936,124,14,14,922,119
86000US43805,43805,55,59,44,58,11,17
86000US43811,43811,336,63,44,23,292,59
86000US43812,43812,7705,253,1739,237,5966,276
86000US43821,43821,1523,155,233,84,1290,133
86000US43822,43822,1758,188,292,85,1466,192
86000US43824,43824,1392,97,121,66,1271,96
86000US43830,43830,2360,196,319,138,2041,210
86000US43832,43832,2877,250,483,156,2394,285
86000US43836,43836,58,18,11,14,47,11
86000US43837,43837,668,87,63,32,605,90
86000US43840,43840,484,78,15,11,469,79
86000US43842,43842,142,64,20,20,122,62
86000US43843,43843,579,149,43,38,536,146
86000US43844,43844,1488,139,194,85,1294,140
86000US43845,43845,1877,172,269,68,1608,172
86000US43901,43901,880,93,73,31,807,94
86000US43902,43902,31,27,0,11,31,27
86000US43903,43903,868,120,107,58,761,114
86000US43905,43905,91,68,9,15,82,67
86000US43906,43906,3572,169,698,117,2874,198
86000US43907,43907,2406,175,334,94,2072,163
86000US43908,43908,619,103,112,42,507,97
86000US43910,43910,1228,143,123,61,1105,144
86000US43912,43912,2756,209,511,113,2245,203
86000US43913,43913,721,94,136,68,585,105
86000US43914,43914,39,33,19,29,20,14
86000US43915,43915,545,93,49,28,496,87
86000US43917,43917,1294,153,111,41,1183,151
86000US43920,43920,9257,312,2133,255,7124,360
86000US43925,43925,155,97,40,60,115,88
86000US43926,43926,121,37,28,17,93,32
86000US43927,43927,41,16,0,11,41,16
86000US43928,43928,0,11,0,11,0,11
86000US43930,43930,360,82,62,41,298,79
86000US43931,43931,128,55,12,19,116,56
86000US43932,43932,336,75,61,22,275,71
86000US43933,43933,829,125,52,33,777,125
86000US43934,43934,218,73,7,12,211,74
86000US43935,43935,3685,221,765,140,2920,229
86000US43938,43938,2211,129,400,111,1811,159
86000US43939,43939,209,50,71,38,138,34
86000US43940,43940,104,56,12,19,92,56
86000US43942,43942,1211,134,172,49,1039,127
86000US43943,43943,1251,90,173,54,1078,93
86000US43944,43944,851,159,58,51,793,154
86000US43945,43945,1235,123,223,61,1012,131
86000US43946,43946,826,136,83,38,743,129
86000US43947,43947,2139,149,283,117,1856,187
86000US43948,43948,204,52,44,27,160,46
86000US43950,43950,5371,223,401,117,4970,270
86000US43951,43951,40,18,0,11,40,18
86000US43952,43952,7300,356,2441,276,4859,317
86000US43953,43953,4802,237,484,154,4318,267
86000US43961,43961,170,45,38,22,132,39
86000US43962,43962,32,13,1,2,31,13
86000US43963,43963,569,55,62,21,507,53
86000US43964,43964,3876,197,661,124,3215,223
86000US43967,43967,0,11,0,11,0,11
86000US43968,43968,2659,222,759,154,1900,235
86000US43970,43970,21,22,0,11,21,22
86000US43971,43971,529,68,83,31,446,62
86000US43972,43972,65,41,0,11,65,41
86000US43973,43973,843,101,140,51,703,99
86000US43974,43974,37,15,0,11,37,15
86000US43976,43976,678,81,110,43,568,83
86000US43977,43977,838,109,112,43,726,105
86000US43983,43983,273,109,50,60,223,91
86000US43985,43985,44,17,3,4,41,17
86000US43986,43986,788,106,218,65,570,94
86000US43988,43988,993,129,177,67,816,125
86000US44001,44001,8342,190,552,180,7790,273
86000US44003,44003,1766,188,389,108,1377,179
86000US44004,44004,13520,425,3626,333,9894,426
86000US44010,44010,639,109,173,77,466,102
86000US44011,44011,7866,310,310,170,7556,331
86000US44012,44012,9288,230,322,125,8966,262
86000US44017,44017,7174,251,790,181,6384,284
86000US44021,44021,2223,140,141,60,2082,126
86000US44022,44022,6861,208,126,54,6735,212
86000US44023,44023,6511,214,275,112,6236,238
86000US44024,44024,9171,254,590,134,8581,267
86000US44026,44026,4437,201,161,71,4276,215
86000US44028,44028,3282,158,301,111,2981,165
86000US44030,44030,5947,233,1063,152,4884,252
86000US44032,44032,644,116,176,85,468,115
86000US44035,44035,26968,507,4916,392,22052,524
86000US44039,44039,12417,321,590,149,11827,359
86000US44040,44040,1181,90,9,11,1172,91
86000US44041,44041,6102,258,1199,190,4903,309
86000US44044,44044,4252,327,124,56,4128,305
86000US44045,44045,152,39,9,10,143,39
86000US44046,44046,748,126,68,70,680,108
86000US44047,44047,3256,224,479,143,2777,282
86000US44048,44048,868,132,161,66,707,121
86000US44049,44049,99,21,6,5,93,20
86000US44050,44050,2431,156,74,32,2357,157
86000US44052,44052,11607,342,3800,337,7807,373
86000US44053,44053,7844,253,1223,214,6621,300
86000US44054,44054,4822,186,502,154,4320,264
86000US44055,44055,7501,256,2497,337,5004,354
86000US44056,44056,4563,184,111,64,4452,194
86000US44057,44057,7388,311,710,184,6678,316
86000US44060,44060,25266,389,1631,248,23635,502
86000US44062,44062,4095,213,350,111,3745,228
86000US44064,44064,669,59,26,21,643,62
86000US44065,44065,1735,174,160,96,1575,229
86000US44067,44067,8079,312,243,94,7836,307
86000US44070,44070,13134,288,896,166,12238,370
86000US44072,44072,1822,161,31,36,1791,162
86000US44074,44074,3890,238,387,113,3503,224
86000US44076,44076,1723,165,218,67,1505,170
86000US44077,44077,21828,461,2478,374,19350,472
86000US44080,44080,70,48,0,11,70,48
86000US44081,44081,2604,100,272,80,2332,132
86000US44082,44082,613,140,41,39,572,137
86000US44084,44084,1191,146,85,41,1106,145
86000US44085,44085,1277,205,232,118,1045,185
86000US44086,44086,964,78,57,29,907,83
86000US44087,44087,8315,289,682,179,7633,318
86000US44089,44089,6631,231,673,217,5958,278
86000US44090,44090,4611,261,282,130,4329,280
86000US44092,44092,7631,242,712,150,6919,260
86000US44093,44093,434,83,70,60,364,72
86000US44094,44094,16256,389,1399,206,14857,413
86000US44095,44095,14057,267,1427,236,12630,331
86000US44099,44099,648,103,0,11,648,103
86000US44101,44101,0,11,0,11,0,11
86000US44102,44102,18777,490,7127,413,11650,516
86000US44103,44103,7096,305,3255,287,3841,244
86000US44104,44104,8906,302,5178,279,3728,303
86000US44105,44105,15476,442,6240,372,9236,432
86000US44106,44106,11068,386,2820,297,8248,375
86000US44107,44107,24622,463,3401,290,21221,508
86000US44108,44108,9510,354,3947,354,5563,331
86000US44109,44109,17198,465,6289,398,10909,508
86000US44110,44110,9107,391,3977,440,5130,401
86000US44111,44111,17413,359,3797,342,13616,394
86000US44112,44112,10006,340,3881,333,6125,412
86000US44113,44113,9161,285,2678,218,6483,280
86000US44114,44114,3787,199,1180,247,2607,244
86000US44115,44115,3662,197,1905,181,1757,171
86000US44116,44116,9002,269,407,153,8595,300
86000US44117,44117,4922,281,1354,195,3568,286
86000US44118,44118,15409,378,2315,223,13094,403
86000US44119,44119,5470,342,1042,261,4428,369
86000US44120,44120,16085,501,4499,319,11586,486
86000US44121,44121,13855,340,1971,261,11884,423
86000US44122,44122,13394,345,1066,177,12328,367
86000US44123,44123,8029,286,1611,293,6418,368
86000US44124,44124,17296,367,1044,223,16252,380
86000US44125,44125,11442,314,1938,217,9504,350
86000US44126,44126,7183,173,502,136,6681,217
86000US44127,44127,2006,144,1077,153,929,120
86000US44128,44128,12701,409,3319,358,9382,430
86000US44129,44129,11771,274,1434,196,10337,343
86000US44130,44130,21997,366,2397,298,19600,462
86000US44131,44131,8225,184,192,64,8033,195
86000US44132,44132,6725,210,1615,216,5110,265
86000US44133,44133,12772,334,596,143,12176,365
86000US44134,44134,15842,366,1939,240,13903,427
86000US44135,44135,11806,349,3229,297,8577,411
86000US44136,44136,10473,233,499,141,9974,280
86000US44137,44137,9385,349,2355,306,7030,470
86000US44138,44138,9236,254,264,89,8972,263
86000US44139,44139,8762,224,326,79,8436,231
86000US44140,44140,6062,145,207,85,5855,140
86000US44141,44141,5546,191,66,40,5480,188
86000US44142,44142,7603,190,774,135,6829,226
86000US44143,44143,10775,261,963,200,9812,332
86000US44144,44144,9737,269,1828,254,7909,327
86000US44145,44145,13751,328,556,189,13195,365
86000US44146,44146,13534,371,2031,288,11503,463
86000US44147,44147,7587,307,250,110,7337,301
86000US44149,44149,7417,189,258,100,7159,214
86000US44201,44201,2583,203,232,95,2351,228
86000US44202,44202,7805,259,415,153,7390,281
86000US44203,44203,16515,397,2678,273,13837,487
86000US44212,44212,16927,373,1247,187,15680,380
86000US44214,44214,851,99,133,59,718,87
86000US44215,44215,878,71,83,32,795,70
86000US44216,44216,3464,222,238,121,3226,198
86000US44217,44217,1480,103,186,59,1294,118
86000US44221,44221,13192,374,1330,210,11862,424
86000US44223,44223,7486,286,646,136,6840,312
86000US44224,44224,16269,428,1218,215,15051,438
86000US44230,44230,3444,155,212,105,3232,190
86000US44231,44231,3643,209,320,113,3323,244
86000US44233,44233,2910,135,27,29,2883,138
86000US44234,44234,1294,109,85,42,1209,114
86000US44235,44235,580,88,41,50,539,87
86000US44236,44236,9122,173,257,101,8865,198
86000US44240,44240,15905,533,2136,322,13769,545
86000US44241,44241,7039,363,691,169,6348,389
86000US44243,44243,0,11,0,11,0,11
86000US44250,44250,443,120,110,84,333,115
86000US44251,44251,377,51,2,3,375,52
86000US44253,44253,1075,104,47,30,1028,106
86000US44254,44254,1983,108,378,88,1605,125
86000US44255,44255,3120,208,292,95,2828,211
86000US44256,44256,23713,386,1577,241,22136,470
86000US44260,44260,5098,303,329,135,4769,336
86000US44262,44262,2002,118,118,78,1884,161
86000US44264,44264,1123,92,96,55,1027,91
86000US44265,44265,0,11,0,11,0,11
86000US44266,44266,13392,441,2605,317,10787,440
86000US44270,44270,3285,198,460,117,2825,232
86000US44272,44272,1895,143,154,57,1741,133
86000US44273,44273,2837,196,147,63,2690,196
86000US44274,44274,122,74,31,48,91,77
86000US44275,44275,1260,110,50,25,1210,107
86000US44276,44276,664,72,34,21,630,70
86000US44278,44278,7135,222,806,168,6329,258
86000US44280,44280,1728,146,66,74,1662,150
86000US44281,44281,12347,341,961,226,11386,424
86000US44285,44285,9,9,0,11,9,9
86000US44286,44286,2325,137,102,94,2223,135
86000US44287,44287,2615,234,346,93,2269,207
86000US44288,44288,1404,111,335,73,1069,101
86000US44301,44301,6335,258,1607,226,4728,263
86000US44302,44302,2536,164,785,151,1751,193
86000US44303,44303,3532,184,303,99,3229,192
86000US44304,44304,1437,143,366,80,1071,127
86000US44305,44305,9464,325,2440,286,7024,350
86000US44306,44306,8958,339,3640,324,5318,329
86000US44307,44307,3330,260,1779,221,1551,208
86000US44308,44308,290,64,171,51,119,40
86000US44310,44310,9866,379,3229,389,6637,437
86000US44311,44311,2943,209,1231,148,1712,197
86000US44312,44312,13252,496,1787,280,11465,566
86000US44313,44313,12012,466,1419,300,10593,459
86000US44314,44314,8447,268,2113,248,6334,313
86000US44319,44319,9611,363,613,163,8998,360
86000US44320,44320,8682,403,2575,363,6107,355
86000US44321,44321,5978,263,184,83,5794,284
86000US44333,44333,7420,308,369,104,7051,347
86000US44401,44401,1090,103,104,54,986,109
86000US44402,44402,1226,111,107,67,1119,113
86000US44403,44403,1765,140,148,68,1617,143
86000US44404,44404,649,98,36,25,613,98
86000US44405,44405,3379,146,1306,149,2073,178
86000US44406,44406,8725,298,332,141,8393,271
86000US44408,44408,4496,236,414,123,4082,270
86000US44410,44410,7583,249,609,132,6974,284
86000US44411,44411,752,93,126,55,626,109
86000US44412,44412,1024,86,106,70,918,103
86000US44413,44413,2880,166,430,115,2450,185
86000US44417,44417,702,107,72,37,630,111
86000US44418,44418,555,97,9,13,546,96
86000US44420,44420,6705,274,849,173,5856,302
86000US44423,44423,931,145,117,58,814,139
86000US44425,44425,6504,286,406,114,6098,315
86000US44427,44427,504,132,25,31,479,129
86000US44428,44428,1206,108,148,70,1058,133
86000US44429,44429,1186,104,212,77,974,110
86000US44430,44430,1414,153,194,66,1220,155
86000US44431,44431,1772,157,169,53,1603,162
86000US44432,44432,4416,259,777,148,3639,271
86000US44436,44436,1484,96,247,75,1237,86
86000US44437,44437,1834,187,267,108,1567,210
86000US44438,44438,1750,134,289,89,1461,149
86000US44439,44439,41,29,6,7,35,29
86000US44440,44440,1993,190,202,82,1791,202
86000US44441,44441,671,119,55,47,616,119
86000US44442,44442,1632,157,193,83,1439,151
86000US44443,44443,582,128,84,72,498,116
86000US44444,44444,4263,197,509,151,3754,205
86000US44445,44445,1405,182,207,61,1198,189
86000US44446,44446,8836,325,1334,221,7502,378
86000US44449,44449,464,103,96,63,368,90
86000US44450,44450,725,102,72,36,653,99
86000US44451,44451,1248,88,108,57,1140,99
86000US44452,44452,1202,159,41,39,1161,151
86000US44454,44454,408,116,96,94,312,87
86000US44455,44455,612,143,58,38,554,139
86000US44460,44460,10555,338,1447,285,9108,393
86000US44470,44470,1572,115,127,56,1445,125
86000US44471,44471,4327,178,1100,200,3227,241
86000US44473,44473,1495,80,155,70,1340,120
86000US44481,44481,4343,265,400,127,3943,258
86000US44483,44483,11101,378,2100,257,9001,402
86000US44484,44484,9852,368,1507,236,8345,366
86000US44485,44485,6826,298,2360,267,4466,335
86000US44490,44490,363,59,117,43,246,39
86000US44491,44491,995,105,80,42,915,102
86000US44493,44493,14,23,0,11,14,23
86000US44502,44502,3980,198,1758,195,2222,185
86000US44503,44503,491,77,306,78,185,73
86000US44504,44504,1870,133,652,139,1218,135
86000US44505,44505,7554,322,2694,245,4860,318
86000US44506,44506,1049,123,553,114,496,111
86000US44507,44507,1937,155,1113,160,824,129
86000US44509,44509,5203,239,1874,217,3329,216
86000US44510,44510,947,124,580,147,367,137
86000US44511,44511,8694,312,1620,205,7074,319
86000US44512,44512,14851,407,1754,263,13097,455
86000US44514,44514,9486,350,556,139,8930,344
86000US44515,44515,12107,342,1537,272,10570,366
86000US44601,44601,13997,465,2834,306,11163,510
86000US44606,44606,2200,143,198,69,2002,146
86000US44607,44607,50,31,0,11,50,31
86000US44608,44608,875,131,75,36,800,129
86000US44609,44609,1654,129,330,93,1324,122
86000US44610,44610,64,44,0,11,64,44
86000US44611,44611,736,114,47,41,689,107
86000US44612,44612,2140,127,121,47,2019,128
86000US44613,44613,755,113,116,57,639,104
86000US44614,44614,5082,242,365,129,4717,262
86000US44615,44615,3986,286,497,130,3489,275
86000US44618,44618,2224,162,139,54,2085,161
86000US44620,44620,601,79,51,32,550,73
86000US44621,44621,1801,176,293,97,1508,163
86000US44622,44622,7524,294,938,199,6586,315
86000US44624,44624,1353,151,26,19,1327,152
86000US44625,44625,601,107,36,39,565,104
86000US44626,44626,1164,89,86,33,1078,92
86000US44627,44627,1586,165,76,55,1510,169
86000US44628,44628,417,70,47,36,370,69
86000US44629,44629,955,104,126,42,829,104
86000US44632,44632,3590,200,265,89,3325,213
86000US44633,44633,809,147,13,15,796,144
86000US44634,44634,816,103,24,26,792,107
86000US44637,44637,1133,153,185,64,948,148
86000US44638,44638,586,115,31,37,555,116
86000US44640,44640,78,27,11,7,67,28
86000US44641,44641,8083,235,674,146,7409,245
86000US44643,44643,1271,124,177,89,1094,125
86000US44644,44644,2051,150,252,110,1799,160
86000US44645,44645,845,62,62,23,783,65
86000US44646,44646,18838,416,2472,298,16366,534
86000US44647,44647,7528,261,855,157,6673,280
86000US44651,44651,221,89,25,33,196,80
86000US44652,44652,16,27,16,27,0,11
86000US44653,44653,236,54,49,35,187,47
86000US44654,44654,5912,321,389,111,5523,320
86000US44656,44656,1205,182,99,55,1106,183
86000US44657,44657,3971,244,412,100,3559,252
86000US44659,44659,42,18,0,11,42,18
86000US44661,44661,68,22,9,10,59,23
86000US44662,44662,3584,160,309,88,3275,176
86000US44663,44663,10202,320,1622,263,8580,332
86000US44666,44666,1116,124,103,54,1013,118
86000US44667,44667,5450,210,568,156,4882,220
86000US44669,44669,532,79,21,22,511,86
86000US44670,44670,103,53,0,11,103,53
86000US44671,44671,136,55,31,49,105,61
86000US44672,44672,2103,148,386,100,1717,162
86000US44675,44675,895,142,90,42,805,143
86000US44676,44676,1767,137,162,58,1605,149
86000US44677,44677,979,90,90,44,889,91
86000US44678,44678,132,91,13,21,119,101
86000US44680,44680,1780,116,175,69,1605,118
86000US44681,44681,2429,159,84,42,2345,160
86000US44682,44682,411,70,42,29,369,68
86000US44683,44683,3330,161,867,132,2463,198
86000US44685,44685,10350,333,575,168,9775,345
86000US44687,44687,11,10,0,11,11,10
86000US44688,44688,1195,104,264,70,931,101
86000US44689,44689,206,50,8,7,198,49
86000US44690,44690,63,46,0,11,63,46
86000US44691,44691,17890,404,2640,327,15250,468
86000US44693,44693,22,13,0,11,22,13
86000US44695,44695,642,101,54,19,588,98
86000US44697,44697,102,31,6,8,96,30
86000US44699,44699,354,70,47,27,307,68
86000US44702,44702,562,95,396,84,166,65
86000US44703,44703,3651,253,1378,212,2273,254
86000US44704,44704,1478,190,669,200,809,170
86000US44705,44705,7412,287,2311,265,5101,288
86000US44706,44706,7173,298,1424,242,5749,307
86000US44707,44707,3946,261,1578,215,2368,233
86000US44708,44708,10900,315,1411,243,9489,366
86000US44709,44709,8461,311,1272,241,7189,355
86000US44710,44710,4168,258,1040,195,3128,233
86000US44714,44714,3768,281,784,226,2984,288
86000US44718,44718,5061,222,382,97,4679,238
86000US44720,44720,15977,392,1177,257,14800,410
86000US44721,44721,5560,261,274,114,5286,265
86000US44730,44730,2336,193,260,101,2076,167
86000US44802,44802,385,85,16,11,369,84
86000US44804,44804,457,106,30,20,427,102
86000US44805,44805,12694,336,1615,253,11079,363
86000US44807,44807,885,92,58,27,827,92
86000US44809,44809,166,51,0,11,166,51
86000US44811,44811,4903,264,622,162,4281,297
86000US44813,44813,3174,240,141,53,3033,232
86000US44814,44814,980,125,55,33,925,121
86000US44815,44815,283,54,37,16,246,51
86000US44816,44816,18,27,0,11,18,27
86000US44817,44817,589,81,29,22,560,86
86000US44818,44818,910,94,130,46,780,89
86000US44820,44820,7457,296,1337,184,6120,336
86000US44822,44822,1135,103,87,32,1048,107
86000US44824,44824,1644,184,40,26,1604,177
86000US44825,44825,28,13,6,8,22,11
86000US44826,44826,664,132,77,82,587,126
86000US44827,44827,2914,150,532,98,2382,152
86000US44828,44828,22,24,0,11,22,24
86000US44830,44830,7685,270,1737,237,5948,330
86000US44833,44833,7121,243,986,185,6135,322
86000US44836,44836,939,114,97,38,842,112
86000US44837,44837,1603,167,171,57,1432,159
86000US44838,44838,98,22,4,8,94,21
86000US44839,44839,5286,276,581,166,4705,333
86000US44840,44840,1095,98,53,27,1042,101
86000US44841,44841,206,54,0,11,206,54
86000US44842,44842,2189,142,299,78,1890,147
86000US44843,44843,834,112,56,42,778,107
86000US44844,44844,234,61,24,30,210,54
86000US44846,44846,1136,149,34,26,1102,149
86000US44847,44847,1397,122,122,45,1275,121
86000US44849,44849,915,106,127,70,788,105
86000US44850,44850,23,18,0,11,23,18
86000US44851,44851,1874,154,306,76,1568,155
86000US44853,44853,527,77,13,11,514,77
86000US44854,44854,677,74,48,24,629,74
86000US44855,44855,434,85,37,18,397,86
86000US44856,44856,89,34,10,10,79,33
86000US44857,44857,9418,297,1452,203,7966,337
86000US44859,44859,557,106,58,69,499,95
86000US44861,44861,34,20,0,11,34,20
86000US44864,44864,1484,147,119,52,1365,159
86000US44865,44865,1118,156,174,61,944,153
86000US44866,44866,822,128,63,64,759,118
86000US44867,44867,926,117,31,19,895,114
86000US44870,44870,16940,445,3645,375,13295,567
86000US44874,44874,121,28,22,18,99,24
86000US44875,44875,5836,341,741,171,5095,374
86000US44878,44878,947,136,66,32,881,130
86000US44880,44880,1015,139,54,47,961,149
86000US44881,44881,11,16,0,11,11,16
86000US44882,44882,1260,129,97,42,1163,135
86000US44883,44883,10932,309,1401,221,9531,325
86000US44887,44887,344,62,30,16,314,61
86000US44889,44889,2875,235,336,123,2539,270
86000US44890,44890,4340,213,935,164,3405,239
86000US44901,44901,0,11,0,11,0,11
86000US44902,44902,1788,183,848,129,940,128
86000US44903,44903,9679,408,1921,273,7758,440
86000US44904,44904,5629,263,759,195,4870,344
86000US44905,44905,4668,319,892,196,3776,330
86000US44906,44906,7235,307,1194,196,6041,290
86000US44907,44907,6702,350,1498,291,5204,328
86000US45001,45001,230,44,35,25,195,41
86000US45002,45002,4995,233,573,115,4422,231
86000US45003,45003,236,48,44,21,192,43
86000US45005,45005,12283,284,1292,220,10991,369
86000US45011,45011,23960,559,3819,409,20141,594
86000US45013,45013,20830,443,2484,297,18346,538
86000US45014,45014,17212,504,1306,264,15906,578
86000US45015,45015,4641,253,883,177,3758,242
86000US45030,45030,7608,244,594,188,7014,309
86000US45032,45032,163,48,26,27,137,41
86000US45033,45033,102,37,13,12,89,36
86000US45034,45034,478,101,0,11,478,101
86000US45036,45036,12266,341,1029,225,11237,385
86000US45039,45039,8816,568,212,105,8604,568
86000US45040,45040,19509,499,588,229,18921,520
86000US45041,45041,20,23,20,23,0,11
86000US45042,45042,10635,337,1537,223,9098,342
86000US45044,45044,19399,448,4195,383,15204,483
86000US45050,45050,3394,203,224,121,3170,231
86000US45051,45051,0,11,0,11,0,11
86000US45052,45052,1531,157,118,57,1413,148
86000US45053,45053,1100,143,62,64,1038,158
86000US45054,45054,1037,145,19,29,1018,141
86000US45056,45056,8120,438,421,129,7699,437
86000US45062,45062,244,51,20,16,224,50
86000US45064,45064,1053,131,50,29,1003,134
86000US45065,45065,1774,221,186,101,1588,248
86000US45066,45066,8589,316,220,97,8369,334
86000US45067,45067,5029,274,509,167,4520,362
86000US45068,45068,4240,233,235,122,4005,227
86000US45069,45069,18546,385,509,133,18037,391
86000US45070,45070,86,31,20,15,66,29
86000US45101,45101,1059,94,336,75,723,100
86000US45102,45102,8655,314,1040,198,7615,350
86000US45103,45103,12348,396,1444,256,10904,457
86000US45106,45106,4632,242,548,117,4084,258
86000US45107,45107,3543,209,500,154,3043,263
86000US45111,45111,112,32,16,24,96,29
86000US45112,45112,24,15,3,4,21,14
86000US45113,45113,1291,139,131,56,1160,147
86000US45115,45115,54,57,12,17,42,55
86000US45118,45118,1368,118,97,38,1271,125
86000US45120,45120,1189,208,277,118,912,185
86000US45121,45121,3456,279,781,193,2675,344
86000US45122,45122,4066,327,481,152,3585,281
86000US45123,45123,3579,218,937,151,2642,233
86000US45130,45130,1500,168,72,62,1428,174
86000US45131,45131,108,39,22,19,86,35
86000US45132,45132,138,38,48,24,90,27
86000US45133,45133,9542,352,1920,275,7622,395
86000US45135,45135,1801,151,246,83,1555,167
86000US45140,45140,20285,444,649,170,19636,461
86000US45142,45142,1394,179,205,72,1189,193
86000US45144,45144,1891,159,653,145,1238,130
86000US45145,45145,11,17,0,11,11,17
86000US45146,45146,538,83,127,54,411,69
86000US45147,45147,78,42,0,11,78,42
86000US45148,45148,520,88,54,41,466,82
86000US45150,45150,12649,346,986,225,11663,396
86000US45152,45152,4144,370,235,94,3909,360
86000US45153,45153,651,100,93,74,558,97
86000US45154,45154,3300,194,546,160,2754,221
86000US45155,45155,109,29,39,20,70,25
86000US45156,45156,25,14,4,7,21,11
86000US45157,45157,3571,189,509,121,3062,209
86000US45158,45158,133,34,26,18,107,29
86000US45159,45159,1237,151,197,65,1040,147
86000US45160,45160,400,80,106,43,294,72
86000US45162,45162,1016,148,78,59,938,134
86000US45164,45164,98,29,27,18,71,24
86000US45166,45166,13,14,0,11,13,14
86000US45167,45167,1494,119,304,59,1190,114
86000US45168,45168,684,145,44,30,640,145
86000US45169,45169,1782,156,359,87,1423,150
86000US45171,45171,2343,221,290,101,2053,214
86000US45172,45172,46,28,5,9,41,25
86000US45174,45174,798,54,3,5,795,54
86000US45176,45176,3424,227,466,112,2958,244
86000US45177,45177,9079,263,1356,201,7723,314
86000US45202,45202,7615,267,1382,156,6233,271
86000US45203,45203,1471,170,652,141,819,122
86000US45204,45204,2481,226,846,163,1635,182
86000US45205,45205,7070,377,2620,276,4450,359
86000US45206,45206,5909,227,1600,196,4309,236
86000US45207,45207,2327,169,751,143,1576,176
86000US45208,45208,8976,279,358,155,8618,294
86000US45209,45209,5707,204,528,130,5179,248
86000US45211,45211,16076,494,3277,471,12799,568
86000US45212,45212,10266,359,1612,263,8654,399
86000US45213,45213,5449,320,720,234,4729,352
86000US45214,45214,3573,241,1605,208,1968,231
86000US45215,45215,12691,410,1894,299,10797,494
86000US45216,45216,4025,302,1028,230,2997,311
86000US45217,45217,2981,223,725,167,2256,232
86000US45218,45218,1527,132,88,40,1439,142
86000US45219,45219,6135,294,763,160,5372,296
86000US45220,45220,6486,264,410,145,6076,297
86000US45223,45223,5808,237,1608,227,4200,247
86000US45224,45224,9316,291,1410,219,7906,348
86000US45225,45225,3957,293,2246,275,1711,227
86000US45226,45226,2616,167,158,54,2458,157
86000US45227,45227,8450,308,1044,232,7406,334
86000US45229,45229,6007,335,2480,365,3527,367
86000US45230,45230,11592,345,1013,231,10579,359
86000US45231,45231,16526,522,2643,417,13883,547
86000US45232,45232,2525,154,1474,170,1051,133
86000US45233,45233,5862,214,301,72,5561,215
86000US45236,45236,11004,369,676,181,10328,346
86000US45237,45237,9179,339,2561,315,6618,373
86000US45238,45238,18767,409,2430,351,16337,574
86000US45239,45239,11516,408,1653,320,9863,437
86000US45240,45240,10085,409,1231,258,8854,466
86000US45241,45241,9875,303,338,144,9537,332
86000US45242,45242,8626,270,229,84,8397,286
86000US45243,45243,5499,239,189,99,5310,270
86000US45244,45244,10318,272,844,172,9474,278
86000US45245,45245,8219,320,544,174,7675,373
86000US45246,45246,6072,346,864,213,5208,372
86000US45247,45247,9333,356,374,120,8959,336
86000US45248,45248,9608,337,520,178,9088,349
86000US45249,45249,5419,260,353,143,5066,280
86000US45251,45251,8528,328,1066,208,7462,357
86000US45252,45252,1868,99,42,44,1826,106
86000US45255,45255,8631,294,475,167,8156,310
86000US45301,45301,36,35,0,11,36,35
86000US45302,45302,1384,103,31,22,1353,104
86000US45303,45303,856,113,119,52,737,103
86000US45304,45304,2685,154,158,72,2527,158
86000US45305,45305,4270,211,94,79,4176,247
86000US45306,45306,1003,106,45,26,958,106
86000US45307,45307,114,31,13,11,101,27
86000US45308,45308,1656,139,137,59,1519,145
86000US45309,45309,5293,201,278,122,5015,237
86000US45310,45310,91,31,1,3,90,30
86000US45311,45311,2240,163,263,73,1977,165
86000US45312,45312,520,97,23,16,497,94
86000US45314,45314,1383,132,84,37,1299,132
86000US45315,45315,1650,194,51,57,1599,194
86000US45316,45316,36,15,0,11,36,15
86000US45317,45317,298,77,15,23,283,71
86000US45318,45318,2152,139,172,66,1980,147
86000US45319,45319,151,39,19,10,132,38
86000US45320,45320,6034,188,842,221,5192,217
86000US45321,45321,330,41,50,22,280,40
86000US45322,45322,8751,341,874,197,7877,408
86000US45323,45323,2290,120,208,84,2082,128
86000US45324,45324,16713,484,2612,250,14101,525
86000US45325,45325,971,126,39,29,932,119
86000US45326,45326,392,77,19,12,373,75
86000US45327,45327,3604,156,246,115,3358,178
86000US45328,45328,226,46,35,17,191,44
86000US45330,45330,385,69,44,33,341,64
86000US45331,45331,9745,278,1139,183,8606,296
86000US45332,45332,316,67,22,17,294,70
86000US45333,45333,483,72,68,51,415,74
86000US45334,45334,859,87,109,47,750,90
86000US45335,45335,2576,131,315,78,2261,144
86000US45336,45336,58,18,0,11,58,18
86000US45337,45337,696,112,26,15,670,110
86000US45338,45338,2012,117,127,37,1885,116
86000US45339,45339,554,109,69,77,485,106
86000US45340,45340,238,50,0,11,238,50
86000US45341,45341,1603,126,243,99,1360,143
86000US45342,45342,15439,557,1556,248,13883,584
86000US45344,45344,5908,214,908,116,5000,221
86000US45345,45345,2326,218,357,153,1969,262
86000US45346,45346,852,106,81,36,771,107
86000US45347,45347,1822,139,257,56,1565,141
86000US45348,45348,367,73,13,14,354,72
86000US45349,45349,124,30,12,9,112,31
86000US45350,45350,30,12,6,8,24,11
86000US45351,45351,92,21,0,11,92,21
86000US45352,45352,91,26,9,8,82,25
86000US45353,45353,72,29,0,11,72,29
86000US45354,45354,214,49,10,11,204,49
86000US45356,45356,10094,301,1431,266,8663,408
86000US45358,45358,120,29,12,10,108,32
86000US45359,45359,702,90,51,29,651,88
86000US45360,45360,189,41,14,9,175,40
86000US45361,45361,135,47,8,9,127,48
86000US45362,45362,487,102,4,4,483,102
86000US45363,45363,570,69,2,3,568,69
86000US45365,45365,11780,318,1565,235,10215,321
86000US45368,45368,1932,121,285,78,1647,139
86000US45369,45369,1303,115,195,53,1108,119
86000US45370,45370,979,110,31,24,948,111
86000US45371,45371,7610,325,315,108,7295,333
86000US45372,45372,154,27,23,13,131,27
86000US45373,45373,13956,409,1347,253,12609,485
86000US45377,45377,6806,300,764,201,6042,317
86000US45378,45378,125,31,17,10,108,31
86000US45380,45380,1837,137,118,53,1719,142
86000US45381,45381,2081,131,238,67,1843,148
86000US45382,45382,445,53,98,42,347,52
86000US45383,45383,2904,200,222,126,2682,228
86000US45384,45384,109,65,9,15,100,62
86000US45385,45385,15784,385,2401,234,13383,421
86000US45387,45387,2507,167,237,78,2270,186
86000US45388,45388,266,61,1,2,265,61
86000US45389,45389,196,44,10,8,186,42
86000US45390,45390,1345,85,288,59,1057,85
86000US45402,45402,4365,262,1657,222,2708,217
86000US45403,45403,6067,311,2049,258,4018,310
86000US45404,45404,4091,326,1566,263,2525,273
86000US45405,45405,8106,389,2637,333,5469,406
86000US45406,45406,9130,381,2898,306,6232,328
86000US45409,45409,3083,177,177,73,2906,185
86000US45410,45410,6891,333,1921,247,4970,338
86000US45414,45414,8930,306,1825,262,7105,338
86000US45415,45415,5557,302,579,185,4978,300
86000US45416,45416,2261,197,623,180,1638,228
86000US45417,45417,12375,385,4879,325,7496,363
86000US45418,45418,689,113,91,48,598,110
86000US45419,45419,6478,299,515,145,5963,311
86000US45420,45420,11844,323,1718,244,10126,405
86000US45424,45424,19282,494,2301,322,16981,489
86000US45426,45426,6956,282,1444,220,5512,293
86000US45428,45428,0,11,0,11,0,11
86000US45429,45429,11660,251,742,133,10918,276
86000US45430,45430,2810,142,98,56,2712,155
86000US45431,45431,11967,410,1174,295,10793,441
86000US45432,45432,6460,310,434,125,6026,315
86000US45433,45433,582,66,58,41,524,70
86000US45434,45434,4461,171,99,66,4362,189
86000US45439,45439,4035,242,992,236,3043,267
86000US45440,45440,9026,241,503,98,8523,271
86000US45449,45449,8020,341,1222,203,6798,409
86000US45458,45458,12752,408,638,160,12114,451
86000US45459,45459,12316,363,357,139,11959,376
86000US45502,45502,6218,239,372,112,5846,236
86000US45503,45503,14179,381,2859,348,11320,432
86000US45504,45504,6790,250,963,150,5827,252
86000US45505,45505,8263,266,2836,282,5427,296
86000US45506,45506,5385,236,1842,206,3543,232
86000US45601,45601,20785,460,4607,381,16178,525
86000US45612,45612,1987,227,594,159,1393,181
86000US45613,45613,1223,191,218,94,1005,182
86000US45614,45614,1835,174,387,114,1448,186
86000US45616,45616,599,127,268,104,331,83
86000US45617,45617,61,89,0,11,61,89
86000US45618,45618,6,5,0,11,6,5
86000US45619,45619,2894,227,658,181,2236,219
86000US45620,45620,434,86,136,49,298,66
86000US45621,45621,133,44,33,18,100,40
86000US45622,45622,60,33,24,26,36,25
86000US45623,45623,1227,118,305,83,922,118
86000US45624,45624,0,11,0,11,0,11
86000US45628,45628,1987,177,426,130,1561,222
86000US45629,45629,975,130,284,93,691,132
86000US45630,45630,28,26,0,11,28,26
86000US45631,45631,5959,277,1139,181,4820,276
86000US45634,45634,713,96,193,63,520,88
86000US45636,45636,47,44,0,11,47,44
86000US45638,45638,8522,318,2386,292,6136,383
86000US45640,45640,6493,337,1316,253,5177,362
86000US45642,45642,0,11,0,11,0,11
86000US45644,45644,1827,187,70,40,1757,186
86000US45645,45645,1135,214,267,162,868,174
86000US45646,45646,103,70,15,27,88,66
86000US45647,45647,891,145,166,86,725,143
86000US45648,45648,4583,294,1396,252,3187,303
86000US45650,45650,161,69,54,60,107,37
86000US45651,45651,2304,171,656,127,1648,163
86000US45652,45652,1416,177,350,148,1066,176
86000US45653,45653,1742,210,351,132,1391,204
86000US45654,45654,353,85,75,48,278,82
86000US45656,45656,2635,225,490,126,2145,232
86000US45657,45657,855,151,246,102,609,145
86000US45658,45658,881,109,299,94,582,92
86000US45659,45659,920,160,261,96,659,143
86000US45660,45660,3007,270,904,165,2103,230
86000US45661,45661,2859,265,742,163,2117,270
86000US45662,45662,12390,368,4213,332,8177,365
86000US45663,45663,2428,176,608,150,1820,194
86000US45669,45669,3991,264,552,145,3439,252
86000US45671,45671,135,60,26,17,109,56
86000US45672,45672,599,112,223,89,376,116
86000US45673,45673,146,68,28,31,118,71
86000US45674,45674,131,52,35,23,96,47
86000US45678,45678,470,183,50,44,420,188
86000US45679,45679,850,112,167,47,683,102
86000US45680,45680,5006,299,1182,236,3824,320
86000US45681,45681,565,114,136,60,429,106
86000US45682,45682,897,111,306,85,591,99
86000US45684,45684,904,144,167,100,737,133
86000US45685,45685,371,90,49,31,322,91
86000US45686,45686,1384,166,391,114,993,147
86000US45688,45688,226,58,66,47,160,41
86000US45690,45690,5626,312,1192,220,4434,333
86000US45692,45692,3336,195,798,188,2538,232
86000US45693,45693,3329,315,926,225,2403,259
86000US45694,45694,4529,289,743,195,3786,295
86000US45695,45695,226,78,76,62,150,51
86000US45696,45696,640,162,109,67,531,150
86000US45697,45697,1870,206,294,99,1576,197
86000US45698,45698,152,44,52,33,100,37
86000US45701,45701,11136,421,1641,258,9495,411
86000US45710,45710,2244,193,316,107,1928,197
86000US45711,45711,432,93,58,36,374,89
86000US45714,45714,4151,230,526,135,3625,217
86000US45715,45715,904,143,158,62,746,132
86000US45716,45716,189,41,52,26,137,40
86000US45719,45719,447,87,171,55,276,68
86000US45721,45721,12,17,12,17,0,11
86000US45723,45723,1464,160,270,74,1194,158
86000US45724,45724,759,157,101,88,658,156
86000US45727,45727,257,104,37,28,220,104
86000US45729,45729,538,93,86,52,452,98
86000US45732,45732,1697,145,493,93,1204,146
86000US45734,45734,213,58,23,24,190,51
86000US45735,45735,618,104,84,46,534,96
86000US45740,45740,146,37,44,22,102,30
86000US45741,45741,319,79,140,52,179,59
86000US45742,45742,1223,166,56,41,1167,165
86000US45743,45743,633,94,136,69,497,87
86000US45744,45744,1075,154,123,59,952,150
86000US45745,45745,559,115,90,71,469,107
86000US45746,45746,237,67,81,49,156,65
86000US45750,45750,11378,278,1970,304,9408,396
86000US45760,45760,1539,139,601,93,938,124
86000US45761,45761,771,120,186,92,585,119
86000US45764,45764,3100,218,758,142,2342,203
86000US45766,45766,436,127,79,49,357,123
86000US45767,45767,1051,159,179,62,872,169
86000US45768,45768,696,143,46,59,650,139
86000US45769,45769,2619,196,663,140,1956,172
86000US45770,45770,243,61,94,53,149,63
86000US45771,45771,1399,133,307,90,1092,134
86000US45772,45772,699,130,136,64,563,129
86000US45773,45773,54,39,0,11,54,39
86000US45775,45775,421,110,30,23,391,109
86000US45776,45776,311,78,74,47,237,76
86000US45778,45778,317,90,74,57,243,75
86000US45779,45779,253,45,55,23,198,39
86000US45780,45780,1320,154,372,139,948,145
86000US45782,45782,171,43,57,21,114,41
86000US45784,45784,1365,205,323,152,1042,199
86000US45786,45786,1352,132,46,37,1306,139
86000US45787,45787,37,33,0,11,37,33
86000US45788,45788,452,111,0,11,452,111
86000US45789,45789,62,67,0,11,62,67
86000US45801,45801,8782,325,2005,263,6777,381
86000US45804,45804,6016,309,1624,209,4392,328
86000US45805,45805,9364,319,1306,192,8058,344
86000US45806,45806,4317,199,431,105,3886,206
86000US45807,45807,4803,236,261,102,4542,242
86000US45808,45808,157,33,24,17,133,33
86000US45809,45809,45,28,5,9,40,31
86000US45810,45810,2638,165,317,106,2321,190
86000US45812,45812,730,111,158,67,572,89
86000US45813,45813,1439,98,96,42,1343,97
86000US45814,45814,1094,118,107,68,987,121
86000US45816,45816,158,39,19,13,139,36
86000US45817,45817,2592,138,154,69,2438,153
86000US45819,45819,104,25,3,5,101,24
86000US45820,45820,181,40,21,17,160,39
86000US45821,45821,555,71,52,38,503,72
86000US45822,45822,8109,282,886,160,7223,275
86000US45826,45826,194,51,11,12,183,50
86000US45827,45827,727,88,50,34,677,82
86000US45828,45828,2371,175,119,61,2252,179
86000US45830,45830,2212,168,189,80,2023,167
86000US45831,45831,1261,102,94,39,1167,95
86000US45832,45832,1143,112,114,48,1029,112
86000US45833,45833,4280,201,341,95,3939,214
86000US45835,45835,227,46,17,15,210,44
86000US45836,45836,529,64,50,29,479,56
86000US45838,45838,17,14,11,14,6,4
86000US45840,45840,24211,425,2555,360,21656,516
86000US45841,45841,328,66,16,14,312,64
86000US45843,45843,1462,168,169,53,1293,163
86000US45844,45844,1244,85,86,41,1158,94
86000US45845,45845,1106,92,16,16,1090,94
86000US45846,45846,1483,71,45,30,1438,76
86000US45849,45849,402,77,69,37,333,74
86000US45850,45850,1235,108,145,83,1090,110
86000US45851,45851,259,67,15,11,244,67
86000US45853,45853,489,86,0,11,489,86
86000US45854,45854,161,34,18,14,143,34
86000US45855,45855,62,19,6,6,56,20
86000US45856,45856,1981,121,194,55,1787,119
86000US45858,45858,1184,123,132,70,1052,131
86000US45859,45859,195,37,57,23,138,29
86000US45860,45860,833,99,0,11,833,99
86000US45861,45861,70,23,17,13,53,21
86000US45862,45862,625,98,67,33,558,92
86000US45863,45863,438,71,33,20,405,69
86000US45864,45864,73,23,2,3,71,22
86000US45865,45865,1885,108,28,18,1857,106
86000US45866,45866,77,24,11,11,66,21
86000US45867,45867,380,100,22,14,358,100
86000US45868,45868,264,60,21,17,243,59
86000US45869,45869,1747,103,39,23,1708,103
86000US45870,45870,57,28,4,6,53,30
86000US45871,45871,747,70,39,27,708,67
86000US45872,45872,1542,121,217,73,1325,142
86000US45873,45873,873,98,132,48,741,94
86000US45874,45874,918,100,189,89,729,99
86000US45875,45875,4408,183,324,106,4084,235
86000US45876,45876,323,50,7,11,316,51
86000US45877,45877,828,85,57,30,771,84
86000US45879,45879,2450,167,397,114,2053,167
86000US45880,45880,1076,92,122,54,954,88
86000US45881,45881,473,100,33,20,440,101
86000US45882,45882,1053,87,42,20,1011,86
86000US45883,45883,1265,83,33,26,1232,81
86000US45884,45884,54,51,0,11,54,51
86000US45885,45885,5164,212,730,160,4434,235
86000US45886,45886,243,69,32,19,211,61
86000US45887,45887,1651,123,205,74,1446,136
86000US45888,45888,72,21,16,14,56,17
86000US45889,45889,492,112,7,9,485,110
86000US45890,45890,212,34,12,9,200,33
86000US45891,45891,6219,207,1006,167,5213,262
86000US45894,45894,259,63,27,20,232,62
86000US45895,45895,7261,253,492,138,6769,250
86000US45896,45896,785,93,51,24,734,96
86000US45897,45897,24,24,0,11,24,24
86000US45898,45898,467,75,26,18,441,75
86000US45899,45899,70,26,6,9,64,23
